PIDGEOT=SHADOWEND,SHADOWSKY
VULPIX=SHADOWWAVE,SHADOWDOWN
GROWLITHE=SHADOWBLITZ,SHADOWBLITZ
GEODUDE=SHADOWBLITZ,SHADOWSHED
RAPIDASH=SHADOWRUSH,SHADOWBLITZ,SHADOWWAVE
DODRIO=SHADOWRUSH,SHADOWSKY
VOLTORB=SHADOWWAVE,SHADOWPANIC
EEVEE=SHADOWBLITZ,SHADOWMIST
PORYGON=SHADOWWAVE,SHADOWPANIC
DRAGONITE=SHADOWEND,SHADOWBREAK,SHADOWPANIC,SHADOWSKY
POLITOED=SHADOWDOWN,SHADOWHALF
SCIZOR=SHADOWBREAK,SHADOWDOWN
DONPHAN=SHADOWRUSH,SHADOWSHED
LARVITAR=SHADOWRUSH,SHADOWSHED
LUGIA=SHADOWBLAST,SHADOWSHED,SHADOWDOWN,SHADOWSTORM
BRELOOM=SHADOWHOLD,SHADOWRUSH
MAWILE=SHADOWRUSH,SHADOWDOWN,SHADOWHOLD
MEDICHAM=SHADOWRUSH,SHADOWDOWN
ELECTRIKE=SHADOWWAVE,SHADOWMIST
WAILMER=SHADOWBLITZ,SHADOWDOWN
FLYGON=SHADOWSTORM,SHADOWBREAK,SHADOWSKY
CACNEA=SHADOWBLITZ,SHADOWHOLD
SWABLU=SHADOWRAVE,SHADOWSKY
ABSOL=SHADOWBREAK,SHADOWDOWN
METANG=SHADOWRUSH,SHADOWPANIC
KYOGRE=SHADOWSURF,SHADOWDOWN,SHADOWCHILL,SHADOWSKY
GROUDON=SHADOWHEAT,SHADOWDOWN,SHADOWFIRE,SHADOWSKY
RAYQUAZA=SHADOWGALE,SHADOWWRATH,SHADOWCRUSH,SHADOWSKY
RIOLU=SHADOWBREAK,SHADOWDOWN
TOXICROAK=SHADOWBREAK,SHADOWDOWN
MAGNEZONE=SHADOWRAVE,SHADOWPANIC
SHAYMIN=SHADOWWAVE,SHADOWSKY,SHADOWDOWN,SHADOWHALF
DRILBUR=SHADOWRUSH,SHADOWPANIC
DUOSION=SHADOWWAVE,SHADOWMIST,SHADOWDOWN
REUNICLUS=SHADOWWAVE,SHADOWMIST,SHADOWDOWN,SHADOWHALF
VANILLITE=SHADOWBLITZ,SHADOWHOLD
EELEKTROSS=SHADOWBOLT,SHADOWPANIC
CRYOGONAL=SHADOWCHILL,SHADOWSKY
KELDEO=SHADOWSWORD,SHADOWWRATH,SHADOWCRUSH,SHADOWHOLD
CHESNAUGHT=SHADOWCRUSH,SHADOWHALF,SHADOWSKY,SHADOWDOWN
DELPHOX=SHADOWFIRE,SHADOWHALF,SHADOWSKY,SHADOWDOWN
GRENINJA=SHADOWCRUSH,SHADOWHALF,SHADOWSKY,SHADOWDOWN
